#######################
#S#                   #
# #              #  ###
# ################    #
#                     #
#                     #
#                     #
#                     #
#                     #
#                     #
#                     #
#                     #
#                     #
#                     #
#                     #
#                     #
#                     #
#                     #
#                     #
#                     #
#                     #
#                     #
#                     #
#                     #
#                     #
#                     #
#                     #
#                     #
#                     #
#                     #
#                     #
#                     #
#                     #
#                     #
#                     #
#                     #
#                    E#
#######################