#########################################
#                                       #
#                                       #
#                                       #
#                                       #
#                  #                    #
#                  #                    #
#                  #                    #
#                  #       ##### ###    #
#        S         #       #E      #    #
#                  #       #########    #
#                  #                    #
#                  ##############       #
#                                       #
#                                       #
#                                       #
#                                       #
#########################################